XXXXXXXXXXXXXXXXXXXX
PPVVVHVVVCVVVVCVVVOO
VOVVVMVVVCVVVVCVVVOO
VPVPGBDPPVPPHPCSVNOO
VOVVVVCPPPPPMPCPPPPP
VOVVVVCVVCVVBDCPCVCW
VOVVVPPVVCVVVVHVCVCW
VOVVVVPPPCVVSVMVCVCW
VOVVVVVVPPPPPGBDCPCE
VOVVVVVVCVVVVVVVCPPP
VOEVVVVVCVVVVVVVCVVW
VOVVAVVVCVVVVVVVCVVW
WWWWWWWPCPWWWOWWCWWW
WVVVVVVVVVVVVOVVCEWW
WWWWWWWWWWWWWOWWWWWW