VVVVVVVVVVVVVVVVVVVV
PPVCHVVCVVVVCEVVVVVO
VOACMVVCVSVVCVVVVVVO
VPPGBDPNPPHPCNVVVVVO
VOVVVCPPPPMPPPPGVVVO
VOVVVCVCVVBDVVCVVVVO
VOVPPCECVVVVVVCVVVVO
VOVVPPPCVVSVVVCSVVVO
VOVVVVPPPPPPPPCPPPPO
VOVVVVVVVVVVVVCVVVVO
VOEVVVVVVVVVVVVVVVVO
VOVVVVVVVVVVVVVVVVVO
WWWWWWWWWWWWWWWWWWWW
WWWWWWWWWWWWWWWWWWWW
WWWWWWWWWWWWWWWWWWWW
