XXXXXXXXXXXXXXXXXXXX
OVVVVVOSCOOVVVVVHVCO
OAVVVVOECOOVEVVVMVCO
PPPPPCPPCPPPPPPGBPCO
OVVVHCVVCVVCCVVVVVCO
OSVEMCVVCVVCCVVVVVCO
PPPGBCVVCVVCCVVVVVCO
OVVVVCVVCVVCCVPPPPPO
OVNVVCVVCVVCCHVVVVVO
PPPPPCPPCPPCCMVVVEVO
OVVVVCOVCVOVCBPPPPPO
OVVVVCOPCEOVCVVOVVVO
WWWWWWWWWWWWCVWWWWWW
WWVVVVVVVVVVCVVEVSVW
WWWWWWWWWWWWWWWWWWWW