XXXXXXXXXXXXXXXXXXXX
PPVCHVVCVVVVCEVVVVVO
VOACMVVCVSVVCVVVVVVO
VPPGBDPNPPHPCVVVVVVO
VOVVVCPPPPMPPPPGVVVO
VOVVVCVCVVBDVVCVVVVO
VOVPPCECVVVVVVCVVVVO
VOVVPPPCVVSVVVCVVVVO
VOVVVVPPPPPPPPCPPPPO
VOVVVVVVVVVVVVCVVVVO
VOEVVVVVVVVVVVVVVVVO
VOVVVVVVVVSVVVVVVVVO
WWWWWWWWWWWWWWWWWWWW
WWWWWWWWWWWWWWWWWWWW
WWWWWWWWWWWWWWWWWWWW
